1111111111
10000000C1
1011111101
1P1E000001
1111111111
