1111111111111111111111111111111
1000000000000000000000000010001
1011111111001111111111100010001
10100000010010000C0000100000001
1000C00001001011111110111110001
1001111111001010000010000010001
1001100000001000000011100110001
1001100111001000000000000010001
10E100001000000P000000000000001
1111111111111111111111111111111