1111111111111111111111111111111
1000000000000C0000000000001C1C1
101111111100111111111110C010101
101C0000C11C10000C0000100000101
1000C00001C01C11111110111110101
100111111100111000C100000C10101
1001100000001C0010001110C110101
10011001110010001C1000000010101
10E1C0001000100P100001C1C000001
1111111111111111111111111111111